000000000000
001110000000
001101100000
001110011000
001111111110
011111121410
011161111110
001111111310
000111111110
000111111100
000111001100
000000000000
#