0000000000
0111111110
0111111110
0111110110
0115112110
0111113110
0111111110
0111111110
0000000000
#